tilemap 9 16 4 40 .png
0 /tiles/space.png
1 /tiles/grass.png
2 /tiles/rock.png collidable
3 /tiles/empty.png
2 2 2 2 2 2 2 2 2 2 2 2 2 2 2 2
2 0 0 0 0 0 0 0 0 0 0 0 0 0 0 2
2 0 0 0 0 1 0 0 0 0 0 0 0 1 0 2
2 0 0 0 0 0 0 0 0 0 0 0 0 0 0 2
2 0 0 0 0 0 0 0 0 0 2 2 2 2 2 2
2 0 0 0 0 0 0 1 0 0 2 3 3 3 3 3
2 0 1 0 0 0 0 0 0 0 2 3 3 3 3 3
2 0 0 0 0 0 0 0 0 0 2 3 3 3 3 3
2 2 2 2 2 2 2 2 2 2 2 3 3 3 3 3